############                             #######
#####       #######    ##   ############ A######
###    # ##   #### ##    ## ##### ##############
### ####               ##      #       B######## 
### #    ##  #### ###### ############## ########
############               ###  ###       
                 