###                 #########
#   ###################   # #
# ####                # # # #
# ################### # # # #
#                     # # # #
### ################# # # # #
#   ##      #         # # # #
# # ## ### ## ######### # # #
# #    #   ##B#         # # #
# # ## ################ # # #
### ##             #### # # #
### ############## ## # # # #
###             ##    # # # #
###### ######## ####### # # #
###### ####             #   #
A      ######################
