####B               
   ######           
         #######    
               ##   
    ########    ##  
   ##      ###   #  
  ##         ##  ## 
  #  #######  ##  # 
  #  #     ##  ## # 
 ## ##  ##  #   # # 
 #  #  ##A# #  ## # 
 # ##  #    #  #  # 
 # ##  ######  #  # 
 #  #         ## ## 
 ## ##      ###  #  
  #  ########   ##  
  #            ##   
  ##  ##########    
   ####             
                    
