   ########    ##A  #    
 #     #    #            
 #     #    ######## ### 
 ##### # #### #  #   # # 
 #     #      #  #     # 
 #   # #####     ####### 
 #####     ###  ##    #  
     #       #  ##  # #  
 # ### ####  #      # #  
##  #  #     # ## ### #  
    #  #   # # #  #   #  
   B#####  #   #  #      
 #####  #  #   #  #####  
        ## #####  #   #  
        #         #      
