######################
#                   B#
# ##################
# ###              #
#     ############ #
# ### #            #
##### # ############
##### #              
#A    #################