#######################################################
#######################################################
## #           #         #     #                    B##
## # ######### # ##### # ##### ################# # # ##
## #                   #           #         # # # # ##
## ### # # ####### ############# ### ##### # # # # # ##
##     # #       # #     #   #       #     #     # # ##
## ##### ####### # # ### # # ### ##### ####### # ### ##
##       #       #     #   #   #   #   #   #   #   # ##
## ####### ####### ########### ##### ### ### ##### # ##
##                                 # #   #   #     # ##
## ############### ### # ####### ##### ### ### ##### ##
##       #   #   # #   # #   #   #     #     # #   # ##
## ##### ### # # # # ### # ### # ##### # ##### # # # ##
## #   #     # # # #     # #   # #   #   # #   # #   ##
## # # ####### # # ####### # ### # # # ### # ### ### ##
##   #       # # # #         # #   # #     # #   # # ##
## ####### ### # # # ######### ##### ##### # # ### # ##
## #     # #   #   #         #   #   #   # # #   # # ##
## # ### # # # ############# ### # ### # # # ### # # ##
##A             #              #         #           ##
#######################################################
#######################################################