##############################
#                          # #
#      ##### ############  # #
#  #####     #       # #   # #
#  #         ###     # ##  # #
#  #  ########   ### ## #  # #
#  #  #  #   #   #    # #### #
#  #     #   # ###    # #    #
#  #######   #   #    # #    #
#            #   #    #  #   #
# ###            #    #  #   #
# # ## ######### #    #  #   #
# # ##         # #    #  #####
# # #          # #       #   #
# # #          # #       #   #
# # ##       ### #########   #
# #  #                       #
# #   ################       #
#B             #             #
##############################
