################
#          
#     ## ##
#     ##B##
#     ##
#     #####
#     #####
#       A