############                             #######
#####        ######    ##   ############ A#######
###    ####   #### ##    ## ##### ##############
### ####          B    ##      #       ######### 
###      ##  #### ###### ########################
############               ###  ###       
                 