############                             #######
#####       #######    ##   ############ A#######
###    # ##   #### ##    ## ##### ##############
### ####               ##      #       B######### 
### #    ##  #### ###### ############## #########
############               ###  ###       
                 