                   #                                   
 #         ###    ##       ######        ####   ####   
 # ##### ###      #     ##      ##          #####  #   
 # #       #   ####### ##############       #      ##  
 # #       #   #     #    #     #   ###    #        #  
 ###   #   #   #     #    #     #     ##   ##       #  
   #   ##  #   #     #          #      ######       #  
        ########     ##  ###    #      #      #######  
    #          #      #  #  ##  #      #      #     #  
    #  ##     A#  ########   ## # ######      #        
    #   #####     #     ###   # #    #        #        
  # #   ##  ##   #      # ##### ##   #    #   #  #     
 #  ######   #   #  B            #  ##    #   #  #     
 ## # # #    #   #      #     #  #  ##    #   #  #     
  #   # #     ####      # ##   ###  ##    #   #  ##    
  #   # #        #      ###### #  #### ####   #    ####
  ##### #       ##      #    #    ## # #  #####        
        #  #  ###       #    ##      # #               
        #  #  #        ##     #     ## #               
     ####  #  # ########       #    #  ###########     
    ##     #  ###               ##  ##           ###   
   ##      # ###                 ##########       #    
          ##              ####                    #    
          #              ##                            
          #              #                             
