#######################################################
#######################################################
##B#           #         #                       #   ##
## # ######### # ##### # ##### ################# # # ##
## #   # #     # #     #       #   #         # # # # ##
## ### # # ####### ############# ### ##### # # # # # ##
##     # #       # #     #   #       #     #   # # # ##
######## ####### # # ### # # ### ##### ####### # ### ##
##       #       #     #   #   #   #   #   #   #   # ##
## ####### ################### ##### ### ### ##### # ##
##         #           #             #   #   #     # ##
## ######### # # # ### # ####### ##### ### ### ##### ##
##       #   # # # #   # #   #   #     #     # #   # ##
######## ### # # # # ### # ### # ##### # ##### # # # ##
## #   #     # # # #     # #   # #   #   # #   # #   ##
## # # ####### ### ####### # ### # # # ### # ### ### ##
##   #       #   # #         # #   # #     # #   # # ##
## ####### ##### # # ######### ##### ##### # # ### # ##
## #     # #   # # #         #   #   #   # # #   # # ##
## # ### # # # # # ######### ### # ### # ### ### # # ##
##   #   #   #     #             #     #         #  A##
#######################################################
#######################################################