######################
#                    #
# ##################
# ###              #
#     ############ #
# ### #    B       #
##### # ############
#####                
#A    #################