###  ###
          #
 #####    #
 # ##     #
   # #    #
# ## #   B#
#A   ##
